1001;0;08/54/17 03:54;20.9;1
1002;0;08/55/17 03:55;20.9;1
1003;0;08/55/17 03:55;20.9;1
1004;0;08/55/17 03:55;20.9;1
1005;2;08/02/17 04:02;2.7;1
1006;1;08/09/17 04:09;9.5;0
1007;0;08/12/17 04:12;6.0;1
1008;1;08/14/17 04:14;6.0;0
1009;1;08/16/17 04:16;6.0;1
1010;0;08/29/17 04:29;15.2;1
1011;1;08/29/17 04:29;6.0;1
1012;1;08/08/17 06:08;8.5;1
1013;1;08/08/17 06:08;1.2;1
1014;0;08/43/17 10:43;2.7;1
1015;0;08/44/17 10:44;0.0;1
1016;0;08/44/17 10:44;0.0;1
1017;0;08/08/17 11:08;7.5;1
1018;0;08/08/17 11:08;0.0;0
1019;0;08/08/17 11:08;0.0;0
1020;2;08/09/17 11:09;0.0;0
1021;0;09/38/17 03:38;6.5;1
1022;1;09/05/17 04:05;10.0;1
1023;0;10/13/17 09:13;19.7;1
1024;2;11/55/17 12:55;18.3;0
