1001;08/08/17 06:08;1001;1;0;1;2;2;2;3;1
1002;08/08/17 06:08;1001;1;0;1;1;0;1
1003;08/43/17 10:43;1001;0;0;1;1;1;5;1
1004;08/08/17 11:08;1001;0;0;1;0;1;4;1
1005;09/36/17 03:36;1001;0;1;0;1;2;1;2;1
1006;09/04/17 04:04;1001;1;1;0;1;2;1;4;1
1007;09/06/17 04:06;1001;0;0;2;1;0;1;1;1
1008;10/12/17 09:12;1001;0;1;0;1;2;2;4;4;1
1009;10/31/17 10:31;1001;2;0;1;1;2;0;5;1
1010;11/52/17 12:52;1001;2;1;0;1;1;2;4;2;1
1011;11/52/17 12:52;1001;2;1;0;2;2;1;1;2;1
